5t  6f  8f  7f  2t  4f  1f  3t  9t
3f  4t  2t  5f  1t  9f  8f  7f  6f
1t  9f  7t  3t  8f  6t  5t  4f  2f
7t  3f  4f  8t  9t  5t  6f  2t  1t
6t  8f  5f  2t  3f  1f  7t  9t  4t
2t  1t  9f  4t  6t  7f  3f  8f  5t
9f  2f  6f  1t  7f  8t  4f  5f  3t
8f  5f  1t  9f  4t  3f  2t  6t  7f
4f  7f  3t  6f  5f  2f  9t  1f  8t